111111111
100C000C1
100000101
1000C0101
1P010E1C1
111111111
